index,Series,Product Name,PureQty,ImpureQty,FinalQty
0,iPhone 15 Base,AT Minimal Case For iPhone 15- 81016- Clear,1,0,1
1,iPhone 15 Base,AT Minimal Magsafe Case For iPhone 15 -81054 -Clear,18,5,23
2,iPhone 15 Base,Gripp Alpine Case for Apple iPhone 15(6.1) - Black,5,2,7
3,iPhone 15 Base,Gripp Alpine Magsafe Case for Apple iPhone 15(6.1) - Black,9,4,13
4,iPhone 15 Base,Gripp Bolt Case for Apple iPhone 15 (6.1) - Black,4,3,7
5,iPhone 15 Base,Gripp Bolt Case for Apple iPhone 15 Max (6.7) - Black,157,61,218
6,iPhone 15 Base,Gripp Bolt MagSafe Case for Apple iPhone 15 (6.1) - Black,6,7,13
7,iPhone 15 Base,Gripp Bolt MagSafe Case for Apple iPhone 15 Max (6.7) - Black,97,52,149
8,iPhone 15 Base,Gripp CLARION Case for Apple iPhone 15 (6.1) - Black,8,8,16
9,iPhone 15 Base,Gripp CLARION Case for Apple iPhone 15 Max (6.7) - Black,68,22,90
10,iPhone 15 Base,Gripp CLARION MAGSAFE Case for Apple iPhone 15 (6.1) - Black,15,8,23
11,iPhone 15 Base,Gripp CLARION MAGSAFE Case for Apple iPhone 15 Max  6.7    Black,55,33,88
12,iPhone 15 Base,Gripp Clear Case for Apple iPhone 15 (6.1) - Clear,30,8,38
13,iPhone 15 Base,Gripp Clear Case for Apple iPhone 15 Max (6.7) - Clear,196,45,241
14,iPhone 15 Base,Gripp Clear MagSafe Case for Apple iPhone 15 (6.1) with White Ring - Clear,20,8,28
15,iPhone 15 Base,Gripp Clear MagSafe Case for Apple iPhone 15 Max  6.7  with White Ring - Clear,421,130,551
16,iPhone 15 Base,Gripp Combat Case for Apple iPhone 15 (6.1) - Clear,7,3,10
17,iPhone 15 Base,Gripp Combat Case for Apple iPhone 15 (6.1) - Smoke,10,1,11
18,iPhone 15 Base,Gripp Combat Case for Apple iPhone 15 Max (6.7) - Smoke,8,1,9
19,iPhone 15 Base,Gripp Combat Magsafe Case for Apple iPhone 15 (6.1) - Clear,4,1,5
20,iPhone 15 Base,Gripp Combat Magsafe Case for Apple iPhone 15 (6.1) - Smoke,7,6,13
21,iPhone 15 Base,Gripp Combat Magsafe Case for Apple iPhone 15 Max (6.7) - Clear,4,10,14
22,iPhone 15 Base,Gripp Defender Case for Apple iPhone 15 (6.1) - Black,7,1,8
23,iPhone 15 Base,Gripp Defender Case for Apple iPhone 15 Max (6.7) - Black,11,12,23
24,iPhone 15 Base,Gripp Defender Magsafe Case for Apple iPhone 15 (6.1) - Black,7,6,13
25,iPhone 15 Base,Gripp Defender Magsafe Case for Apple iPhone 15 Max (6.7) - Black,3,12,15
26,iPhone 15 Base,Gripp HERITAGE XTREME Magsafe Case for Apple iPhone 15 Max- Black,48,32,80
27,iPhone 15 Base,Gripp HERITAGE XTREME Magsafe Case for Apple iPhone 15- Black,4,4,8
28,iPhone 15 Base,Gripp ICE FROST Case for Apple iPhone 15 (6.1) - Clear Frost,9,4,13
29,iPhone 15 Base,Gripp ICE FROST MagSafe Case for Apple iPhone 15 (6.1) with White Ring - Clear Frost,61,38,99
30,iPhone 15 Base,Gripp ICE FROST MagSafe Case for Apple iPhone 15 Max (6.7) with White Ring - Clear Frost,128,72,200
31,iPhone 15 Base,Gripp NEO Case for Apple iPhone 15 (6.1) - Smoke,10,4,14
32,iPhone 15 Base,Gripp NEO Case for Apple iPhone 15 Max (6.7) - Smoke,55,21,76
33,iPhone 15 Base,Gripp NEO MagSafe Case for Apple iPhone 15 (6.1) - Smoke,11,5,16
34,iPhone 15 Base,Gripp NEO MagSafe Case for Apple iPhone 15 Max (6.7) - Smoke,90,41,131
35,iPhone 15 Base,Gripp NEO XTREME Magsafe Case for Apple iPhone 15 (6.1) - Clear,7,4,11
36,iPhone 15 Base,Gripp NEO XTREME Magsafe Case for Apple iPhone 15 (6.1) - Smoke,4,6,10
37,iPhone 15 Base,Gripp Raigor Magsafe case for Apple iPhone 15 (6.1) - Black,0,1,1
38,iPhone 15 Base,Gripp Rubon Magsafe Case for Apple iPhone 15 (6.1) - Black,3,3,6
39,iPhone 15 Base,Gripp Rubon Magsafe Case for Apple iPhone 15 (6.1) - Grey,1,2,3
40,iPhone 15 Base,Gripp Rubon Magsafe Case for Apple iPhone 15 (6.1) - Sierra Blue,10,10,20
41,iPhone 15 Base,Gripp Rubon Magsafe Case for Apple iPhone 15 Max (6.7) - Black,73,34,107
42,iPhone 15 Base,Gripp Slim Fit Magsafe Case for Apple  iPhone 15 Max  6.7  - Black,8,8,16
43,iPhone 15 Base,Gripp Slim Fit Magsafe Case for Apple  iPhone 15 Max  6.7  - Blue,16,5,21
44,iPhone 15 Base,Gripp Slim Fit Magsafe Case for Apple  iPhone 15 Max  6.7  - Transparent,19,8,27
45,iPhone 15 Base,Gripp Vintage Magsafe Case for Apple iPhone 15 (6.1) - Black,5,0,5
46,iPhone 15 Base,Gripp Vintage Magsafe Case for Apple iPhone 15 Max (6.7) - Black,42,13,55
47,iPhone 15 Base,HYPHEN AIRE Clear Soft Case - iPhone 15 - 6.1,3,3,6
48,iPhone 15 Base,HYPHEN AIRE MagSafe Clear Case - iPhone 15 - 6.1 10ft Drop-Tested Case,22,13,35
49,iPhone 15 Base,HYPHEN DURO Drop Case - iPhone 15 - 6.1 10ft Drop-Tested Case,7,5,12
50,iPhone 15 Base,HYPHEN DURO MagSafe Drop Case - iPhone 15 - 6.1 10ft Drop-Tested Case,20,4,24
51,iPhone 15 Base,HYPHEN LUCD MagSafe Case - iPhone 15 - 6.1,13,9,22
52,iPhone 15 Base,Pulse Armor Magsafe case for iPhone 15 Black,269,74,343
53,iPhone 15 Base,Pulse Clear Magsafe Case for iPhone 15-Clear,291,58,349
54,iPhone 15 Base,Pulse FROSTED Case for iPhone 15-Black,270,85,355
55,iPhone 15 Base,Pulse HORNOR Case for iPhone 15-Black,304,80,384
56,iPhone 15 Base,Pulse HORNOR Case for iPhone 15-Blue,216,55,271
57,iPhone 15 Base,Pulse LIQUID silicon case for iPhone 15-Black,290,98,388
58,iPhone 15 Base,Pulse LIQUID silicon case for iPhone 15-Storm Blue,291,102,393
59,iPhone 15 Base,Pulse Newton Magsafe Case for iPhone 15-Black,289,77,366
60,iPhone 15 Base,Pulse Newton Magsafe Case for iPhone 15-Blue,241,81,322
61,iPhone 15 Base,Pulse Newton Magsafe Case for iPhone 15-Grey,297,103,400
62,iPhone 15 Base,Pulse Super crystal magsafe case for iPhone 15-Black,315,90,405
63,iPhone 15 Base,Pulse Super crystal magsafe case for iPhone 15-Clear,259,56,315
64,iPhone 15 Base,Pulse TANK Gradient Magsafe case for iPhone 15-Blue,256,86,342
65,iPhone 15 Base,Pulse THOR Leather case for iPhone 15-Black,284,109,393
66,iPhone 15 Base,Pulse THOR Leather case for iPhone 15-Blue,283,98,381
67,iPhone 15 Base,Pulse Tire magsafe case for iPhone 15 Black,290,98,388
68,iPhone 15 Base,Roskilde MagSafe - iPhone 15 - Black,4,6,10
69,iPhone 15 Base,Roskilde MagSafe - iPhone 15 - Tan,1,4,5
70,iPhone 15 Plus,AT Minimal Case For iPhone 15 plus- 81023- Clear,1,1,2
71,iPhone 15 Plus,AT Minimal Magsafe Case For iPhone 15 Plus-81061-Clear,16,2,18
72,iPhone 15 Plus,HYPHEN AIRE Clear Soft Case - iPhone 15 Plus - 6.7,3,1,4
73,iPhone 15 Plus,HYPHEN AIRE MagSafe Clear Case - iPhone 15 Plus - 6.7 10ft Drop-Tested Case,4,1,5
74,iPhone 15 Plus,HYPHEN DURO Drop Case - iPhone 15 Plus - 6.7 10ft Drop-Tested Case,0,2,2
75,iPhone 15 Plus,HYPHEN LUCD Magsafe Case Case - iPhone 15 Plus - 6.7,1,1,2
76,iPhone 15 Plus,Roskilde MagSafe - iPhone 15 Plus - Black,5,3,8
77,iPhone 15 Plus,nmaxn IPhone 15 Plus Case 750 Series Navy Blue  Handmade   Fully Covered   Nature Pattern AP 15PL 7503,0,1,1
78,iPhone 15 Plus,nmaxn iPhone 15 Plus Case 750 Series Capsicum Red/ Handmade - Fully Covered / Nature Pattern  AP-15PL-7504,0,1,1
79,iPhone 15 Pro,Gripp Alpine Case for Apple iPhone 15 Pro (6.1) - Black,1,0,1
80,iPhone 15 Pro,Gripp Alpine Magsafe Case for Apple iPhone 15 Pro (6.1) - Black,1,2,3
81,iPhone 15 Pro,Gripp Bolt Case for Apple iPhone 15 Pro  6.1  - Black,1,1,2
82,iPhone 15 Pro,Gripp Bolt MagSafe Case for Apple iPhone 15 Pro (6.1) - Black,0,1,1
83,iPhone 15 Pro,Gripp CLARION Case for Apple iPhone 15 Pro (6.1) - Black,1,5,6
84,iPhone 15 Pro,Gripp CLARION MAGSAFE Case for Apple iPhone 15 Pro (6.1) - Black,4,5,9
85,iPhone 15 Pro,Gripp Clear Case for Apple iPhone 15 Pro (6.1) - Clear,1,7,8
86,iPhone 15 Pro,Gripp Clear MagSafe Case for Apple iPhone 15 Pro (6.1) with White Ring - Clear,8,15,23
87,iPhone 15 Pro,Gripp Combat Case for Apple iPhone 15 Pro (6.1) - Clear,1,1,2
88,iPhone 15 Pro,Gripp Combat Case for Apple iPhone 15 Pro (6.1) - Smoke,0,1,1
89,iPhone 15 Pro,Gripp Combat Magsafe Case for Apple iPhone 15 Pro (6.1) - Clear,0,4,4
90,iPhone 15 Pro,Gripp Defender Case for Apple iPhone 15 Pro (6.1) - Black,1,0,1
91,iPhone 15 Pro,Gripp Defender Magsafe Case for Apple iPhone 15 Pro  6.1  - Black,4,4,8
92,iPhone 15 Pro,Gripp ICE frost Case for Apple iPhone 15 Pro (6.1) - Clear Frost,0,3,3
93,iPhone 15 Pro,Gripp ICE frost MagSafe Case for Apple iPhone 15 Pro (6.1) with White Ring - Clear Frost,0,1,1
94,iPhone 15 Pro,Gripp NEO Case for Apple iPhone 15 Pro (6.1) - Smoke,0,1,1
95,iPhone 15 Pro,Gripp Rubon MagSafe Case for Apple iPhone 15 Pro (6.1) - Black,0,5,5
96,iPhone 15 Pro,Gripp Rubon MagSafe Case for Apple iPhone 15 Pro (6.1) - Grey,0,2,2
97,iPhone 15 Pro,Gripp Rubon MagSafe Case for Apple iPhone 15 Pro (6.1) - Sierra Blue,1,8,9
98,iPhone 15 Pro,Gripp Vintage Magsafe Case for Apple iPhone 15 Pro (6.1) - Black,0,2,2
99,iPhone 15 Pro,HYPHEN AIRE Clear Soft Case - iPhone 15 Pro - 6.1,2,2,4
100,iPhone 15 Pro,HYPHEN AIRE MagSafe Clear Case - iPhone 15 Pro - 6.1 10ft Drop-Tested Case,0,4,4
101,iPhone 15 Pro,HYPHEN DURO Drop Case - iPhone 15 Pro - 6.1 10ft Drop-Tested Case,5,5,10
102,iPhone 15 Pro,HYPHEN DURO MagSafe Drop Case - iPhone 15 Pro - 6.1 10ft Drop-Tested Case,1,1,2
103,iPhone 15 Pro,HYPHEN LUCD Magsafe Case Case - iPhone 15 Pro - 6.1,0,2,2
104,iPhone 15 Pro,HYPHEN NOCT MagSafe Frame Case - Black - iPhone 15 Pro - 6.1,0,1,1
105,iPhone 15 Pro,HYPHEN NOCT MagSafe Frame Case - Titanium Grey - iPhone 15 Pro - 6.1,1,1,2
106,iPhone 15 Pro,Pulse Armor Magsafe case for iPhone 15 Pro Black,43,77,120
107,iPhone 15 Pro,Pulse Tire magsafe case for iPhone 15 Pro Black,40,83,123
108,iPhone 15 Pro,Roskilde MagSafe - iPhone 15 Pro - Tan,0,5,5
109,iPhone 15 Pro,nmaxn IPhone 15 Pro Case 750 Series Capsicum Red/ Handmade - Fully Covered / Nature Pattern AP-15PR-7504,0,1,1
110,iPhone 15 Pro,nmaxn iPhone 15 Pro Case 750 Series Brown  Handmade   Fully Covered   Nature Pattern AP 15PR 7502,0,1,1
111,iPhone 15 Pro Max,AT Minimal Magsafe Case For iPhone 15 Pro Max-81085-Clear,8,9,17
112,iPhone 15 Pro Max,AT Minimal Magsafe Case For iPhone 15 Pro Max-81108-Gray,1,1,2
113,iPhone 15 Pro Max,AT Minimal Magsafe Case For iPhone 15 Pro Max-81122-Blue,1,1,2
114,iPhone 15 Pro Max,AT Titan Pro Magsafe Case For iPhone 15 Pro Max-81269-Clear,0,1,1
115,iPhone 15 Pro Max,Gripp Alpine Case for Apple iPhone 15 Pro Max (6.7) - Black,1,1,2
116,iPhone 15 Pro Max,Gripp Alpine Magsafe Case for Apple iPhone 15 Pro Max (6.7) - Black,0,3,3
117,iPhone 15 Pro Max,Gripp Bolt Case for Apple iPhone 15 Pro Max (6.7) - Black,7,15,22
118,iPhone 15 Pro Max,Gripp Bolt MagSafe Case for Apple iPhone 15 Pro Max (6.7) - Black,0,2,2
119,iPhone 15 Pro Max,Gripp CLARION Case for Apple iPhone 15 Pro Max (6.7) - Black,1,4,5
120,iPhone 15 Pro Max,Gripp CLARION MAGSAFE Case for Apple iPhone 15 Pro Max (6.7) - Black,6,5,11
121,iPhone 15 Pro Max,Gripp Clear Case for Apple iPhone 15 Pro Max (6.7) - Clear,7,10,17
122,iPhone 15 Pro Max,Gripp Clear MagSafe Case for Apple iPhone 15 Pro Max (6.7) with White Ring - Clear,4,8,12
123,iPhone 15 Pro Max,Gripp Combat Case for Apple iPhone 15 Pro Max (6.7) - Clear,1,9,10
124,iPhone 15 Pro Max,Gripp Combat Case for Apple iPhone 15 Pro Max (6.7) - Smoke,1,4,5
125,iPhone 15 Pro Max,Gripp Combat Magsafe Case for Apple iPhone 15 Pro Max (6.7) - Clear,2,2,4
126,iPhone 15 Pro Max,Gripp Combat Magsafe Case for Apple iPhone 15 Pro Max (6.7) - Smoke,3,4,7
127,iPhone 15 Pro Max,Gripp Defender Case for Apple iPhone 15 Pro Max (6.7) - Black,3,3,6
128,iPhone 15 Pro Max,Gripp Defender Magsafe Case for Apple iPhone 15 Pro Max (6.7) - Black,3,5,8
129,iPhone 15 Pro Max,Gripp HERITAGE XTREME Magsafe Case for Apple iPhone 15 Pro Max(6.7) - Camel,2,19,21
130,iPhone 15 Pro Max,Gripp HERITAGE XTREME Magsafe Case for Apple iPhone 15 Pro Max(6.7) - Grey,1,7,8
131,iPhone 15 Pro Max,Gripp HERITAGE XTREME Magsafe Case for Apple iPhone 15 Pro Max- Black,4,14,18
132,iPhone 15 Pro Max,Gripp HERITAGE XTREME Magsafe Case for Apple iPhone 15 Pro Max- Blue,0,2,2
133,iPhone 15 Pro Max,Gripp HERITAGE XTREME Magsafe Case for Apple iPhone 15 Pro Max- Brown,0,10,10
134,iPhone 15 Pro Max,Gripp ICE frost Case for Apple iPhone 15 Pro Max (6.7) - Clear Frost,0,2,2
135,iPhone 15 Pro Max,Gripp ICE frost MagSafe Case for Apple iPhone 15 Pro Max (6.7) with White Ring - Clear Frost,3,6,9
136,iPhone 15 Pro Max,Gripp NEO Case for Apple iPhone 15 Pro Max (6.7) - Smoke,0,1,1
137,iPhone 15 Pro Max,Gripp NEO MagSafe Case for Apple iPhone 15 Pro Max (6.7) - Smoke,0,6,6
138,iPhone 15 Pro Max,Gripp NEO XTREME Magsafe Case for Apple iPhone 15 Pro Max(6.7) - Clear,1,5,6
139,iPhone 15 Pro Max,Gripp NEO XTREME Magsafe Case for Apple iPhone 15 Pro Max(6.7) - Smoke,0,3,3
140,iPhone 15 Pro Max,Gripp Raigor Magsafe case for Apple iPhone 15 Pro Max (6.7) - Black,1,2,3
141,iPhone 15 Pro Max,Gripp Raigor Magsafe case for Apple iPhone 15 Pro Max (6.7) - Blue,0,3,3
142,iPhone 15 Pro Max,Gripp Raigor Magsafe case for Apple iPhone 15 Pro Max (6.7) - Red,0,1,1
143,iPhone 15 Pro Max,Gripp Rubon Magsafe Case for Apple iPhone 15 Pro Max (6.7) - Black,3,3,6
144,iPhone 15 Pro Max,Gripp Rubon Magsafe Case for Apple iPhone 15 Pro Max (6.7) - Grey,1,2,3
145,iPhone 15 Pro Max,Gripp Rubon Magsafe Case for Apple iPhone 15 Pro Max (6.7) - Sierra Blue,5,11,16
146,iPhone 15 Pro Max,HYPHEN AIRE Clear Soft Case - iPhone 15 Pro Max - 6.7,1,6,7
147,iPhone 15 Pro Max,HYPHEN AIRE MagSafe Clear Case - iPhone 15 Pro Max - 6.7 10ft Drop-Tested Case,7,11,18
148,iPhone 15 Pro Max,HYPHEN DURO Drop Case - iPhone 15 Pro Max - 6.7 10ft Drop-Tested Case,8,10,18
149,iPhone 15 Pro Max,HYPHEN DURO MagSafe Drop Case - iPhone 15 Pro Max - 6.7 10ft Drop-Tested Case,1,11,12
150,iPhone 15 Pro Max,HYPHEN LUCD Magsafe Case Case - iPhone 15 Pro Max - 6.7,3,5,8
151,iPhone 15 Pro Max,Pulse Armor Magsafe case for iPhone 15 Pro Max Black,81,117,198
152,iPhone 15 Pro Max,Pulse Clear Magsafe Case for iPhone 15 Pro Max-Clear,51,76,127
153,iPhone 15 Pro Max,Pulse FROSTED Case for iPhone 15 Pro Max-Black,88,139,227
154,iPhone 15 Pro Max,Pulse HORNOR Case for iPhone 15 Pro Max-Black,66,124,190
155,iPhone 15 Pro Max,Pulse HORNOR Case for iPhone 15 Pro Max-Blue,46,85,131
156,iPhone 15 Pro Max,Pulse LIQUID silicon case for iPhone 15 Pro Max-Black,80,108,188
157,iPhone 15 Pro Max,Pulse LIQUID silicon case for iPhone 15 Pro Max-Storm Blue,65,109,174
158,iPhone 15 Pro Max,Pulse Newton Magsafe Case for iPhone 15 Pro Max-Black,69,90,159
159,iPhone 15 Pro Max,Pulse Newton Magsafe Case for iPhone 15 Pro Max-Blue,53,105,158
160,iPhone 15 Pro Max,Pulse Newton Magsafe Case for iPhone 15 Pro Max-Grey,71,142,213
161,iPhone 15 Pro Max,Pulse Super crystal magsafe case for iPhone 15 Pro Max-Black,91,114,205
162,iPhone 15 Pro Max,Pulse Super crystal magsafe case for iPhone 15 Pro Max-Clear,84,110,194
163,iPhone 15 Pro Max,Pulse TANK Gradient Magsafe case for iPhone 15 Pro Max-Blue,69,140,209
164,iPhone 15 Pro Max,Pulse THOR Leather case for iPhone 15 Pro Max-Black,85,119,204
165,iPhone 15 Pro Max,Pulse THOR Leather case for iPhone 15 Pro Max-Blue,78,132,210
166,iPhone 15 Pro Max,Pulse TPU TPE PC shockproof case for iPhone 15 Pro Max-Black,102,130,232
167,iPhone 15 Pro Max,Pulse TPU TPE PC shockproof case for iPhone 15 Pro Max-Light Blue,50,106,156
168,iPhone 15 Pro Max,Pulse Tire magsafe case for iPhone 15 Pro Max Black,83,134,217
169,iPhone 16 Base,Gripp Clear Case for Apple iPhone 16  6.1  - Clear,62,18,80
170,iPhone 16 Base,Gripp Clear MagSafe Case for Apple iPhone 16  6.1  with White Ring - Clear,60,21,81
171,iPhone 16 Base,Gripp Dusk Magsafe Case for Apple iPhone 16  6.1  - Black,15,7,22
172,iPhone 16 Base,Gripp Glacier Slim MagSafe Case for Apple iPhone 16  6.1  - Gunmetal,8,1,9
173,iPhone 16 Base,Gripp Glacier Slim MagSafe Case for Apple iPhone 16  6.1  - Natural Titanium,7,3,10
174,iPhone 16 Base,Gripp Holdit MagSafe Case for Apple iPhone 16  6.1  - Grey,2,1,3
175,iPhone 16 Base,Gripp Matrix MagSafe Case for Apple iPhone 16  6.1  - Black,14,5,19
176,iPhone 16 Base,Gripp STELLAR MagSafe Case for Apple iPhone 16  6.1  - Black Matte,24,6,30
177,iPhone 16 Base,Gripp STELLAR MagSafe Case for Apple iPhone 16  6.1  - Blue Matte,25,11,36
178,iPhone 16 Base,Gripp STELLAR MagSafe Case for Apple iPhone 16  6.1  - Green Matte,65,15,80
179,iPhone 16 Base,Gripp STELLAR MagSafe Case for Apple iPhone 16  6.1  - Transparent,26,10,36
180,iPhone 16 Base,Gripp Slim Fit Magsafe Case for Apple iPhone 16  6.1  - Black,6,3,9
181,iPhone 16 Base,Gripp Slim Fit Magsafe Case for Apple iPhone 16  6.1  - Blue,7,4,11
182,iPhone 16 Base,Gripp Slim Fit Magsafe Case for Apple iPhone 16  6.1  - Green,13,6,19
183,iPhone 16 Base,Gripp Slim Fit Magsafe Case for Apple iPhone 16  6.1  - White,8,6,14
184,iPhone 16 Base,PULSE ARMOUR Case for iPhone 16-Black,296,42,338
185,iPhone 16 Base,PULSE ARMOUR Case for iPhone 16-Dark Blue,88,11,99
186,iPhone 16 Base,PULSE ARMOUR Case for iPhone 16-Matt Clear,110,12,122
187,iPhone 16 Base,PULSE Aluminium Rugged Magsafe Case for iPhone 16-Matt Black,231,42,273
188,iPhone 16 Base,PULSE Aluminium Rugged Magsafe Case for iPhone 16-Matt Green,55,5,60
189,iPhone 16 Base,PULSE Aluminium Rugged Magsafe Case for iPhone 16-Matt Grey Blue,128,15,143
190,iPhone 16 Base,PULSE Matt Magsafe Case for iPhone 16-Black,295,55,350
191,iPhone 16 Base,PULSE Matt Magsafe Case for iPhone 16-Blue,118,26,144
192,iPhone 16 Base,PULSE Matt Magsafe Case for iPhone 16-Grey,262,42,304
193,iPhone 16 Base,Pulse CLEAR Case with Camera stand for iPhone 16-Black,106,17,123
194,iPhone 16 Base,Pulse CLEAR Case with Camera stand for iPhone 16-Dark Blue,94,19,113
195,iPhone 16 Base,Pulse CLEAR Case with Camera stand for iPhone 16-Grey,120,16,136
196,iPhone 16 Base,Pulse CLEAR Case with Camera stand for iPhone 16-White,255,33,288
197,iPhone 16 Base,Pulse CRYSTAL Case with Metal Camera Stand for iPhone 16-Black,149,21,170
198,iPhone 16 Base,Pulse CRYSTAL Case with Metal Camera Stand for iPhone 16-Grey,194,32,226
199,iPhone 16 Base,Pulse CRYSTAL Case with Metal Camera Stand for iPhone 16-White,385,69,454
200,iPhone 16 Base,Pulse SILICON Case for iPhone 16-Black,186,37,223
201,iPhone 16 Base,Pulse SILICON Case for iPhone 16-Storm Blue,84,12,96
202,iPhone 16 Base,Pulse Vegan Leather Case for iPhone 16-Black,92,22,114
203,iPhone 16 Base,Pulse Vegan Leather Case for iPhone 16-Blue,50,11,61
204,iPhone 16 Base,Pulse Vegan Leather Case for iPhone 16-Brown,31,7,38
205,iPhone 16 Base,Tekne CLEAR Case with Camera stand for iPhone 16-Black,193,44,237
206,iPhone 16 Base,Tekne CLEAR Case with Camera stand for iPhone 16-Grey,37,10,47
207,iPhone 16 Base,Tekne CLEAR Case with Camera stand for iPhone 16-White,234,36,270
208,iPhone 16 Base,Tekne Matt Magsafe Case for iPhone 16-Black,202,39,241
209,iPhone 16 Base,Tekne Matt Magsafe Case for iPhone 16-Blue,98,21,119
210,iPhone 16 Base,Tekne Matt Magsafe Case for iPhone 16-Grey,185,26,211
211,iPhone 16 Base,Tekne SILICON Case for iPhone 16-Black,130,23,153
212,iPhone 16 Base,UAG- Plasma  XTE  MagSafe Case for iphone 16-15086- Black/Ornage,0,2,2
213,iPhone 16 Plus,Gripp Clear Case for Apple iPhone 16 Plus  6.7  - Clear,37,7,44
214,iPhone 16 Plus,Gripp Clear MagSafe Case for Apple iPhone 16 Plus  6.7  with White Ring - Clear,55,11,66
215,iPhone 16 Plus,Gripp Dusk MagSafe Case for Apple iPhone 16 Plus  6.7  - Black,17,5,22
216,iPhone 16 Plus,Gripp Glacier Slim MagSafe Case for Apple iPhone 16 Plus  6.7  - Gunmetal,10,4,14
217,iPhone 16 Plus,Gripp Glacier Slim MagSafe Case for Apple iPhone 16 Plus  6.7  - Natural Titanium,12,1,13
218,iPhone 16 Plus,Gripp Holdit MagSafe Case for Apple iPhone 16 Plus  6.7  - Grey,8,2,10
219,iPhone 16 Plus,Gripp Matrix MagSafe Case for Apple iPhone 16 Plus  6.7  - Black,15,7,22
220,iPhone 16 Plus,Gripp STELLAR MagSafe Case for Apple iPhone 16 Plus  6.7  - Black Matte,17,5,22
221,iPhone 16 Plus,Gripp STELLAR MagSafe Case for Apple iPhone 16 Plus  6.7  - Blue Matte,31,11,42
222,iPhone 16 Plus,Gripp STELLAR MagSafe Case for Apple iPhone 16 Plus  6.7  - Green Matte,68,15,83
223,iPhone 16 Plus,Gripp STELLAR MagSafe Case for Apple iPhone 16 Plus  6.7  - Transparent,31,4,35
224,iPhone 16 Plus,Gripp Slim Fit Magsafe Case for Apple iPhone 16 Plus  6.7  - Black,3,3,6
225,iPhone 16 Plus,Gripp Slim Fit Magsafe Case for Apple iPhone 16 Plus  6.7  - Blue,1,2,3
226,iPhone 16 Plus,Gripp Slim Fit Magsafe Case for Apple iPhone 16 Plus  6.7  - Green,11,3,14
227,iPhone 16 Plus,Gripp Slim Fit Magsafe Case for Apple iPhone 16 Plus  6.7  - White,5,9,14
228,iPhone 16 Plus,PULSE ARMOUR Case for iPhone 16 Plus-Black,198,22,220
229,iPhone 16 Plus,PULSE ARMOUR Case for iPhone 16 Plus-Dark Blue,96,23,119
230,iPhone 16 Plus,PULSE ARMOUR Case for iPhone 16 Plus-Matt Clear,67,13,80
231,iPhone 16 Plus,PULSE Aluminium Rugged Magsafe Case for iPhone 16 Plus-Matt Black,131,17,148
232,iPhone 16 Plus,PULSE Aluminium Rugged Magsafe Case for iPhone 16 Plus-Matt Green,28,3,31
233,iPhone 16 Plus,PULSE Aluminium Rugged Magsafe Case for iPhone 16 Plus-Matt Grey Blue,49,7,56
234,iPhone 16 Plus,PULSE Matt Magsafe Case for iPhone 16 Plus-Black,145,25,170
235,iPhone 16 Plus,PULSE Matt Magsafe Case for iPhone 16 Plus-Blue,52,8,60
236,iPhone 16 Plus,PULSE Matt Magsafe Case for iPhone 16 Plus-Grey,137,21,158
237,iPhone 16 Plus,Pulse CLEAR Case with Camera stand for iPhone 16 Plus-Black,53,12,65
238,iPhone 16 Plus,Pulse CLEAR Case with Camera stand for iPhone 16 Plus-Dark Blue,56,14,70
239,iPhone 16 Plus,Pulse CLEAR Case with Camera stand for iPhone 16 Plus-Grey,65,15,80
240,iPhone 16 Plus,Pulse CLEAR Case with Camera stand for iPhone 16 Plus-White,123,12,135
241,iPhone 16 Plus,Pulse CRYSTAL Case with Metal Camera Stand for iPhone 16 Plus-Black,106,24,130
242,iPhone 16 Plus,Pulse CRYSTAL Case with Metal Camera Stand for iPhone 16 Plus-Grey,109,13,122
243,iPhone 16 Plus,Pulse CRYSTAL Case with Metal Camera Stand for iPhone 16 Plus-White,208,47,255
244,iPhone 16 Plus,Pulse SILICON Case for iPhone 16 Plus-Black,89,19,108
245,iPhone 16 Plus,Pulse SILICON Case for iPhone 16 Plus-Storm Blue,38,15,53
246,iPhone 16 Plus,Pulse Vegan Leather Case for iPhone 16 Plus-Black,39,9,48
247,iPhone 16 Plus,Pulse Vegan Leather Case for iPhone 16 Plus-Blue,21,6,27
248,iPhone 16 Plus,Pulse Vegan Leather Case for iPhone 16 Plus-Brown,17,6,23
249,iPhone 16 Plus,Tekne ARMOUR Case for iPhone 16 Plus-Matt Clear,144,21,165
250,iPhone 16 Plus,Tekne CLEAR Case with Camera stand for iPhone 16 Plus-Grey,155,31,186
251,iPhone 16 Plus,Tekne CLEAR Case with Camera stand for iPhone 16 Plus-White,29,3,32
252,iPhone 16 Plus,Tekne Matt Magsafe Case for iPhone 16 Plus-Black,144,36,180
253,iPhone 16 Plus,Tekne Matt Magsafe Case for iPhone 16 Plus-Grey,113,17,130
254,iPhone 16 Plus,UAG- Metropolis LT Magsafe Case for iphone 16 Plus- 14348-Kevlar Black,1,0,1
255,iPhone 16 Plus,UAG-Plasma XTE Magsafe Case for iphone 16 Plus- 14997-Black/Orange,1,0,1
256,iPhone 16 Pro,Gripp Clear Case for Apple iPhone 16 Pro  6.3  - Clear,53,46,99
257,iPhone 16 Pro,Gripp Clear MagSafe Case for Apple iPhone 16 Pro  6.3  with White Ring - Clear,57,53,110
258,iPhone 16 Pro,Gripp Dusk MagSafe Case for Apple iPhone 16 Pro  6.3  - Black,51,34,85
259,iPhone 16 Pro,Gripp Glacier Slim MagSafe Case for Apple iPhone 16 Pro  6.3  - Gunmetal,17,16,33
260,iPhone 16 Pro,Gripp Glacier Slim MagSafe Case for Apple iPhone 16 Pro  6.3  - Natural Titanium,41,30,71
261,iPhone 16 Pro,Gripp Glacier Slim MagSafe Case for Apple iPhone 16 Pro  6.3  - Rose Gold,71,53,124
262,iPhone 16 Pro,Gripp Holdit MagSafe Case for Apple iPhone 16 Pro  6.3  - Grey,5,7,12
263,iPhone 16 Pro,Gripp Holdit MagSafe Case for Apple iPhone 16 Pro  6.3  - R.Gold,13,11,24
264,iPhone 16 Pro,Gripp Matrix MagSafe Case for Apple iPhone 16 Pro  6.3  - Black,21,23,44
265,iPhone 16 Pro,Gripp Matrix MagSafe Case for Apple iPhone 16 Pro  6.3  - Gold,35,31,66
266,iPhone 16 Pro,Gripp STELLAR MagSafe Case for Apple iPhone 16 Pro  6.3  - Black Matte,61,36,97
267,iPhone 16 Pro,Gripp STELLAR MagSafe Case for Apple iPhone 16 Pro  6.3  - Gold Matte,94,61,155
268,iPhone 16 Pro,Gripp STELLAR MagSafe Case for Apple iPhone 16 Pro  6.3  - Transparent,68,54,122
269,iPhone 16 Pro,Gripp Slim Fit Magsafe Case for Apple iPhone 16 Pro  6.3  - Black,18,13,31
270,iPhone 16 Pro,Gripp Slim Fit Magsafe Case for Apple iPhone 16 Pro  6.3  - Grey,16,22,38
271,iPhone 16 Pro,Peak Design Mobile - Everyday Clarino Case - iPhone 16 Pro - Black,0,1,1
272,iPhone 16 Pro,Peak Design Mobile - Everyday Clarino Case - iPhone 16 Pro - Tan,1,3,4
273,iPhone 16 Pro,Peak Design Mobile - Everyday Fabric Case - iPhone 16 Pro - Charcoal,1,0,1
274,iPhone 16 Pro,Peak Design Mobile - Everyday Loop Case - iPhone 16 Pro - Charcoal,0,2,2
275,iPhone 16 Pro Max,Gripp Clear Case for Apple iPhone 16 Pro Max  6.9  - Clear,53,33,86
276,iPhone 16 Pro Max,Gripp Clear MagSafe Case for Apple iPhone 16 Pro Max  6.9  with White Ring - Clear,71,52,123
277,iPhone 16 Pro Max,Gripp Dusk MagSafe Case for Apple iPhone 16 Pro Max  6.9  - Black,43,65,108
278,iPhone 16 Pro Max,Gripp Glacier Slim MagSafe Case for Apple iPhone 16 Pro Max  6.9  - Gunmetal,21,24,45
279,iPhone 16 Pro Max,Gripp Glacier Slim MagSafe Case for Apple iPhone 16 Pro Max  6.9  - Natural Titanium,24,28,52
280,iPhone 16 Pro Max,Gripp Glacier Slim MagSafe Case for Apple iPhone 16 Pro Max  6.9  - Rose Gold,41,49,90
281,iPhone 16 Pro Max,Gripp Holdit MagSafe Case for Apple iPhone 16 Pro Max  6.9  - Grey,9,18,27
282,iPhone 16 Pro Max,Gripp Holdit MagSafe Case for Apple iPhone 16 Pro Max  6.9  - R.Gold,23,18,41
283,iPhone 16 Pro Max,Gripp Matrix MagSafe Case for Apple iPhone 16 Pro Max  6.9  - Black,34,39,73
284,iPhone 16 Pro Max,Gripp Matrix MagSafe Case for Apple iPhone 16 Pro Max  6.9  - Gold,30,37,67
285,iPhone 16 Pro Max,Gripp STELLAR MagSafe Case for Apple iPhone 16 Pro Max  6.9  - Black Matte,51,57,108
286,iPhone 16 Pro Max,Gripp STELLAR MagSafe Case for Apple iPhone 16 Pro Max  6.9  - Gold Matte,94,95,189
287,iPhone 16 Pro Max,Gripp STELLAR MagSafe Case for Apple iPhone 16 Pro Max  6.9  - Transparent,81,68,149
288,iPhone 16 Pro Max,Gripp Slim Fit Magsafe Case for Apple iPhone 16 Pro Max  6.9  - Black,13,21,34
289,iPhone 16 Pro Max,Gripp Slim Fit Magsafe Case for Apple iPhone 16 Pro Max  6.9  - Grey,13,19,32
290,iPhone 16 Pro Max,PULSE ARMOUR Case for iPhone 16 Pro Max -Matt Clear,37,34,71
291,iPhone 16 Pro Max,PULSE ARMOUR Case for iPhone 16 Pro Max-Black,142,89,231
292,iPhone 16 Pro Max,PULSE ARMOUR Case for iPhone 16 Pro Max-Dark Blue,21,21,42
293,iPhone 16 Pro Max,PULSE Aluminium Rugged Magsafe Case for iPhone 16 Pro Max -Matt Grey Blue,65,41,106
294,iPhone 16 Pro Max,PULSE Aluminium Rugged Magsafe Case for iPhone 16 Pro Max-Matt Black,112,63,175
295,iPhone 16 Pro Max,PULSE Aluminium Rugged Magsafe Case for iPhone 16 Pro Max-Matt Green,19,8,27
296,iPhone 16 Pro Max,PULSE Matt Magsafe Case for iPhone 16 Pro Max -Grey,106,65,171
297,iPhone 16 Pro Max,PULSE Matt Magsafe Case for iPhone 16 Pro Max-Black,93,82,175
298,iPhone 16 Pro Max,PULSE Matt Magsafe Case for iPhone 16 Pro Max-Blue,28,18,46
299,iPhone 16 Pro Max,Peak Design Mobile - Everyday Clarino Case - iPhone 16 Pro Max - Black,0,2,2
300,iPhone 16 Pro Max,Peak Design Mobile - Everyday Clarino Case - iPhone 16 Pro Max - Tan,0,2,2
301,iPhone 16 Pro Max,Peak Design Mobile - Everyday Fabric Case - iPhone 16 Pro Max - Charcoal,0,2,2
302,iPhone 16 Pro Max,Peak Design Mobile - Everyday Fabric Case - iPhone 16 Pro Max - Eclipse,1,3,4
303,iPhone 16 Pro Max,Peak Design Mobile - Everyday Fabric Case - iPhone 16 Pro Max - Sage,1,1,2
304,iPhone 16 Pro Max,Peak Design Mobile - Everyday Loop Case - iPhone 16 Pro Max - Charcoal,1,1,2
305,iPhone 16 Pro Max,Pulse CLEAR Case with Camera stand for iPhone 16 Pro Max-Black,79,50,129
306,iPhone 16 Pro Max,Pulse CLEAR Case with Camera stand for iPhone 16 Pro Max-Dark Blue,60,36,96
307,iPhone 16 Pro Max,Pulse CLEAR Case with Camera stand for iPhone 16 Pro Max-Grey,67,43,110
308,iPhone 16 Pro Max,Pulse CLEAR Case with Camera stand for iPhone 16 Pro Max-White,149,81,230
309,iPhone 16 Pro Max,Pulse CRYSTAL Case with Metal Camera Stand for iPhone 16 Pro Max-Black,83,55,138
310,iPhone 16 Pro Max,Pulse CRYSTAL Case with Metal Camera Stand for iPhone 16 Pro Max-Grey,72,61,133
311,iPhone 16 Pro Max,Pulse CRYSTAL Case with Metal Camera Stand for iPhone 16 Pro Max-White,165,109,274
312,iPhone 16 Pro Max,Pulse SILICON Case for iPhone 16 Pro Max-Black,68,58,126
313,iPhone 16 Pro Max,Pulse SILICON Case for iPhone 16 Pro Max-Storm Blue,27,29,56
314,iPhone 16 Pro Max,Pulse Vegan Leather Case for iPhone 16 Pro Max -Brown,20,29,49
315,iPhone 16 Pro Max,Pulse Vegan Leather Case for iPhone 16 Pro Max-Black,40,42,82
316,iPhone 16 Pro Max,Pulse Vegan Leather Case for iPhone 16 Pro Max-Blue,20,25,45
317,iPhone 16 Pro Max,Tekne CLEAR Case with Camera stand for iPhone 16 Pro Max-Black,159,123,282
318,iPhone 16 Pro Max,Tekne CLEAR Case with Camera stand for iPhone 16 Pro Max-Grey,51,31,82
319,iPhone 16 Pro Max,Tekne CLEAR Case with Camera stand for iPhone 16 Pro Max-White,203,114,317
320,iPhone 16 Pro Max,Tekne Matt Magsafe Case for iPhone 16 Pro Max-Black,157,114,271
321,iPhone 16 Pro Max,UAG-Civilian  Magsafe Case For Iphone 16 Pro Max-14140-Black,1,0,1
322,iPhone 16 Pro Max,UAG-Pathfinder  Magsafe Case For Iphone 16 Pro Max-14744-Ice,1,2,3
323,iPhone 16 Pro Max,UAG-Pathfinder Magsafe Case For Iphone 16 Pro Max-14751-Active Neon,1,2,3
324,iPhone 16 Pro Max,UAG-Pathfinder Magsafe Case For Iphone 16 Pro Max-14867-Silver,1,0,1
325,iPhone 16 Pro Max,UAG-Pathfinder Magsafe Case For Iphone 16 Pro Max-14874-Black,1,0,1
326,iPhone 16 Pro Max,UAG-Pathfinder Magsafe Case For Iphone 16 Pro Max-14898-Cloud Blue,0,1,1
327,iPhone 16 Pro Max,UAG-Plasma XTE Magsafe Case For Iphone 16 Pro Max-15048-Ash/Titanium,2,1,3
328,iPhone 16 Pro Max,UAG-Plasma XTE Magsafe Case For Iphone 16 Pro Max-15055-Black/Clear,2,0,2
